@@@@@@@@@@@@@@@@@@@@
@                  @
@                  @
@        @@@@      @
@                  @
@                  @
@                  @
@         @        @
@                  @
@      X           @
@     @@@          @
@                  @
@            @@@@@@@
@ I                @
@@@@@@@@@@@        @
@        B         @
@        @@@@@     @
@                  @
@  L              B@
@@@@@@@@@@@@@@@@@@@@
SSSPPNN<
