@@@@@@@@@@@@@@@@@@@@
@                  @
@   L              @
@  @@@             @
@                  @
@                  @
@                  @
@                  @
@                  @
@       B          @
@       @@@@@@@@@@ @
@                  @
@             @@@@@@
@                  @
@                  @
@            @@    @
@              X   @
@                  @
@                  @
@@@@@@@@@@@@@@@@@@@@
NTT>