@@@@@@@@@@@@@@@@@@@@
@                  @
@    L   X <>  TSN @
@  @@@@@@@@@@@ PB  @
@                  @
@ I   @   @        @
@@@@@@@   @        @
@         @        @
@                  @
@     @@@   @@@    @
@                  @
@         @        @
@         @        @
@         @        @
@                  @
@                  @
@                  @
@                  @
@                  @
@@@@@@@@@@@@@@@@@@@@
NTT><SPN

