@@@@@@@@@@@@@@@@@@@@
@                  @
@   L              @
@  @@@             @
@                  @
@                  @
@    @             @
@                  @
@                  @
@                  @
@@ @@@@ @@@@@@@@@@ @
@   P              @
@                  @
@    B      @@@@@@@@
@ @@@@@            @
@                  @
@@@@@@@@@@@@@      @
@                  @
@ X     I          @
@@@@@@@@@@@@@@@@@@@@
TP<<>
