@@@@@@@@@@@@@@@@@@@@
@                  @
@L                 @
@@@@@@@@           @
@                  @
@                  @
@X                 @
@@@@@@@@           @
@                  @
@                  @
@      I           @
@    @@@@@@@       @
@                  @
@                  @
@         I        @
@      @@@@@@@     @
@                  @
@                  @
@   I              @
@@@@@@@@@@@@@@@@@@@@
N<
